00000500000
00000500000
00000500000
33330503333
00000000000
01210001210
02320002320
01210001210
00000000000
00000000000
00000000000