00000000000
00000055555
00000004444
10000000333
22222200022
33333333001
44444444400
55555555550
00000000000
00000000000
00000000000