11111111111
00000000000
55555555555
00000000000
04444444440
00000000000
00333333300
00000000000
00022222000
00000000000
00000000000