00000054321
00000543210
00005432100
00054321000
00543210000
05432100000
54321000000
43210000000
32100000000
21000000000
10000000000