00001510000
55555555555
00001510000
00000500000
00000500000
00040504000
00004540000
00040504000
00000000000
00000000000
00000000000