01000100010
00200200200
00030303000
00004440000
01234543210
00004440000
00030303000
00200200200
01000100010
00000000000
00000000000